encourage - поощрять
cruft - мусор, хлам
responsible - ответственный
rest - остальное
up to you - зависит от тебя
retrieve - извлекать
render - отдавать, отрисовка, рендеринг
feature - возможность
strive - стремиться
allow - позволять
redundancy - избыточности
among - среди, между
and so on - и так далее
pipe - труба, дудка
simplistically - упрощённо
hole - дырка, отверстия
strikingly - поразительно
particularly - в частности
force - сила, заставлять
decoupled - разделённый, отделённый
surface - поверхность, поверхностно
quick - быстрый
feed - корм
feeds - новостные ленты
attractive - привлекательный
barely - едва
possibility - возможность
verify - проверить
encounter - столкнуться
compatible - совместимый
refer - обращаться
poll - опрос
assume - предполагать
prompt - запрос
indicate - указывать

